v1.2
0;0;10;10;#000000
0;2;1:0;0:8;3
0;2;1:0;1:9;3
0;2;1:0;2:9;3
0;2;1:0;3:9;3
0;2;1:0;4:9;3
0;2;1:0;5:9;3
0;2;1:0;6:9;3
0;2;1:0;7:9;3
0;2;1:0;8:9;3
0;2;1:0;9:8;3
0;2;1:3;0:9;3
0;2;1:3;9:9;3
0;1;1:0;6:4;6,50,0,false,0